/|#/||///////////||///|||//////////||||||///////
/|.|..|////////||..|/|...|////||//|......||/////
|.....|////||||....|/|...|///|..|//|||||...||///
/||...||//|........|/|....||||.. |||///|.....|//
//|.....||.......||/||..............|||.......|/
//|............||//|...........................|
/|..|||||||||||//||......||||....||||..........|
/|..|///////////|........||//|..|//||..........|
/|..|////|||//||....||.....|//||/||.....|||||||/
/|...||||...||.....|/|.....||///|.....|/////////
//|.........||..|||/|..||||..|//|.....|||////|||
///|......|///||///||..||||...|||........||/|..|
////||||.|//|||||||.................||.....||..|
///////|.|||...........||||.......||//|........|
//////||............|||////||.....|||||........|
/////|......|||||...||////|||.............|||||/
|||///||....|////|....||||.....|||........||////
|..|||||.....|////|............|||..........|///
|...........|////||................|||||||||////
||||||||||||///////||||||||||||||||/////////////