//#/||///////////||///|||//////////||||||///////
/|.|../////////||..///.../////||///......||/////
/...../////||||....///...|////..|||/////...||///
///...||//|........///....||||.. |||///|.....|//
///.....||.......///||..............|||.......|/
//|............////|...........................|
//../////////////||......////....////........../
//..////////////|........||///..///||........../
//..|////|||//||....//.....//////||.....////////
//...||||...//.....//|.....||////.....//////////
///.........//../////..////..|///.....|||////|||
////....../////////||..||||...|||........||//../
////////.///|||||||.................//.....||../
////////.|||...........////......./////......../
//////||............/////////.....|||||......../
//////....../////...||////|||.............//////
|||/////....|/////....||||.....///........||////
/..|||||.....|/////............|||..........////
/.........../////||................/////////////
////////////////////////////////////////////////